1111111111111111111111
110000P000000000000011
10C0000000000000001111
1111110000000000111111
1111111111111111E11111