1111111111111111111111
110000P000000000000011
10C1000000000000001011
1111110000000000001011
1111111111111111111E11