11111111111
110000P0011
10C00001111
111111E1111