11111111111
100000PC011
10000000111
111111E1111