1111111111111111111111
1100000000000000P00001
10010C1000000000001011
111111000000000E001011
1111111111111111111111