111111111111111111111111111111111111111111111
10000000000000000000000000000000000PCE1111111
100000000000000000000000000000000000000111111
111111111111111111111111111111111111111111111