1111111111111111111111111111111
1P00000000000000000000000000001
1111000111111001111111110001111
100000010000C000000000000000C01
1001111101111001111111001101101
1000000000000010000001001000001
1111001111111011111001111001111
1C00001000000000000100000000001
1000000111001111111011111000111
1011111101110000000010001C00111
1010000000001111111010000000001
1110111110001000000011111011111
100010000C000000000000000000E11
1111111111111111111111111111111