111111111111111111111
110000P00000000000001
10C10000000E000000101
111111000000C00000101
111111111111111111111



















