1111111111
1%$ó000001
1PCE000001
1111111111